# This puzzle is solvable
8
47 48 25 21 18 30 44 31
45 53 35 15 50 22 33  5
60  4 41 42 27 54 16 28
32 13 51 17 29 58 36 10
19  1 39 46 62 40 43 56
 0 52 57 24 59 23 12 11
37 61 26 49 20 34 38  2
 8 63  9 55 14  7  6  3
