# This puzzle is unsolvable
10
  1  83  90   4  10  93  33  99  11  71
  5  36  73  86  70  67  88  12  32  77
 40  37  38  65  51  30  63  42   6  85
 80  62  61  43  50  14  92  48  44   8
 15  39  13   3  91  45  74   9  97  55
 24  94  23  59  81  29  89  16  21  47
 35  75  31  53  25  49  34  98  69   7
 82  95  52  58  18  26  68  46   2  57
 19  96  28  20  66  60  79  22  27  87
 41  17  56  78  72  54   0  76  64  84
