# This puzzle is unsolvable
9
53 11 17 70 27 10 52 60 58
29 77 43 32 64 61 59 22 40
44  3 20 56 80 23 15 33 18
31 41 68 73  2 25 65 49  8
78  5 69 21 34  9 16 75 13
24 57 42  1 12 45 46 63 39
26 76 55 72 19 51 47 30  0
71 54 62 14  4 48  7 38 67
50 79 28 37 36 35  6 74 66
