# This puzzle is unsolvable
30
  3 119   2 118 228 328 231   6   7 126  10  12  14 130  16 125  18 132 135  22  21 245  23 139 343  25  28  29  27  31
116   1   4 325   5 122   8   9 123 230 232 235 129 237 238  15  17 240 133  19  20 136  24  26 141 438 249 142 145  30
115 224 117 417 501 226 124 333  11 421 127 233 334 236 336 131 337 239 243 134 137 242 246 138 349 143 251 348 250 252
114 324 120 323 330 121 227 418  13 505 128 506 234 335 508 428 338 341 241 432 342 516 244 247 140 346 347 248 147  32
223 415 319 225 327 326 504 419 329 229 648 422 581 426 429 430 512 339 340 593 434 518 344 437 436 520 350  34  35 144
221 416 111 321 414 577 643 420 707 649   0 583 503 425 424 841 511 514 588 431 590 433 435 345 439 440 441 253 149 146
222 113 322 112 576 646 575 509 579 580 510 331 507 427 654 586 589 513 655 587 515 591 517 519 596 521 351 148  36  33
320 109 219 498 500 502 645 705 704 759 836 806 332 710 585 652 711 765 715 656 717 658 592 721 595 352 255 254 150  37
108 218 220 110 499 497 573 706 798 578 423 757 709 584 712 714 653 766 842 657 659 719 594 598 522 661 353 151 153  38
217 412 317 318 569 755 644 703 647 800 754 650 758 651 582 869 762 713 716 768 810 767 660 355 663 442 662  41  39  40
107 316 641 572 413 214 496 701 410 756 884 802 761 864 804 805 843 811 888 718 772 600 524 665 443 354 258 523 152 156
106 213 409 411 408 315 638 574 642 571 639 834 803 867 760 840 807 809 808 770 664 720 446 771 444 445 256 259  42 357
215 314 104 494 216 702 700 640 797 708 796 837 801 868 886 865 844 764 763 812 845 769 667 526 599 528 155 257 157 447
105 211 493 210 799 407 489 697 750 833 839 838 883 896 887 898 846 871 847 532 527 724 773 449 525 722 356 154 158 261
212 404 405 311 492 495 752 570 636 835 863 862 866 885 890 899 891 893 848 872 813 448 597 602 666 359 358 450 260  43
102 103 406 312 699 567 491 748 832 795 860 880 897 870 823 877 889 873 814 819 849 669 723 601 530 159 668 160  46 262
100 310 208 313 488 490 637 753 694 793 794 881 856 857 879 894 895 816 850 875 776 815 670 529 603 452 263  48  45  44
 98 209 101 309 698 566 693 751 635 831 792 855 830 825 892 878 777 737 817 851 725 774 677 606 531 362 264 607 360  47
 97 308 403 402 633 692 565 568 749 696 861 882 829 785 858 824 733 852 876 818 671 673 604 674 451 363 361 266 161  49
207  99 307 401 564 487 691 632 746 747 789 739 786 826 827 781 783 779 676 775 680 729 535 540 731 605 267 365 163 265
 96 206 305 485 486 695 563 562 631 743 634 790 686 874 821 820 822 616 780 726 727 617 534 672 608 536 364 162  51  50
205 306 484 399 481 483 744 745 688 828 791 787 685 853 854 618 784 546 734 732 610 728 612 609 537 453 459 272 367 164
 95 204 400 482 629 630 560 561 689 687 742 740 741 859 386 619 547 681 782 678 675 614 778 457 268 368 271 533 269 165
 94 203 304 397 396 559 628 690 627 624 552 622 471 684 549 683 468 544 736 730 377 283 738 456 458 455 270  54 366 166
202 302 303 395 398 558 557 555 625 626 475 788 553 621 682 550 735 679 615 466 545 375 376 542 371 168  56 460  53 273
 93 201 301 480 479 478 391 556 554 476 623 472 473 470 620 288 287 467 382 465 284 279 613 463  59  61 167 454 169  55
 92  91 200 394 393 297 392 477 390 388 474 291 387 551 383 548 469 380 181 282 462 538 172 176 543 278  52 373 611  57
 90 199 300 299 298 194 295 192 389 293 292 385 290 384  74 289 381  70 464 179  71  65 281  68 369  60  62 461 280 372
 89 198 197 196 195  83 296 191 294 190 189 188 187 186 185 182 286 285 379  67 178 541 276  64 174 374 277 274 171 275
 88  87  86  85  84  82 193  81  80  79  78  77  76  75  73 184 183 180  72 378  69 177  66  63 175 370 539 170 173  58
