# This puzzle is unsolvable
20
 76   2   4 206 145   6 207 151 262 341  10  85  84 155  16  15  21  97  20  22
204  78   3   1 149   5  79  86   9 152  87  13 213  92  89  17  90  93  94 160
254  74  77 150 259 301 305 336 338  82 208 210  14  91 267  19 159 163 162  23
 72 141 258 143 144   7 300 299 148 260 153  12  88 269 165 214 218  95  26 161
 73 140 136  75 256  83 307 261 263 340 158 212 339 157  25  98 217 273 156  96
 71 205 257 302 146 147 255  11 264 211 396 154 310 345 100  18 222 226  99 268
253  70 138  80 209 334   8 303 295 335 215 395 265 366 342 221  27 219  24 168
 69 142 197 304 198 361 365 370 297 397 313 364 216 346 344 101 223  28 275 104
 68 296 333 337  81 203 200 387 391 135 389 306 367 164 368 266 315  29 103 220
137 139 394 202 195 383 388 355 308 398 372 390 348 314 228 374 225 102 271 311
331 251 252 294 199 292 381   0 392 385 369 322 353 309 371 276 312 279  36 107
 64 196  67 248 298 250 249 326 343 386 384 236 234 179 347 350 166  34 270  33
201 134 193 192 328 358 332 293 380 362 182 377 317 354 167 106 316 170  32  30
132  65 291 194 363 286 329 379 189 375 349 378 321 274 393 280 282  31 112 272
 63 245 246 133 186 330 327 360 399 357 352 324 224 169 351  43 105 227 172 109
 66 126  61 244 359 287 242 285 356 382  51 323 376 284 373 116 175  38 110 278
 62 128 131 190 124 123 288 185 325 239 183 235 319 281 277 180 176  35  37  42
 59  56 247 130 243 122 289  46 120 121  49  47 233  45 171 114 229 318 230 111
 58 188 191  54  60  55  52  53 241 119 117 237 181 177 283 320 178 232 231 173
127 129  57 125 290 240 184 187  50  48 115 238 118  44 174 108 113  41  40  39
