# This puzzle is unsolvable
8
17 37 38  5 26  9 16 25
36 46 33 30  2 50 11 28
59 13 29 15 23 14 48 49
12 18 60  6 57 31 10 24
39  0 34 58 47 20 22  4
35 42 41  7 19 55 45 40
63 56 21 51 52 54 32 62
 8 44  1 27 53 43 61  3
